A Horse With No Name - America
Ventura Highway - America
One of These Nights - Eagles
Lyin’ Eyes - Eagles
Desperado - Eagles
Take It To the Limit - Eagles
Peaceful  Easy Feeling - Eagles
A Dios Le Pido - Juanes 
A Little Respect - Erasure
Acima do Sol - Bruno Boncini
Adventure of a Lifetime - Coldplay 
Africa - Toto 
All I Wanna Do Is Make Love to You - Halestorm
All You Need Is Love - The Beatles 
America - Simon & Garfunkel
Avantasia - Twisted Mind
Baba ORiley - The Who 
Back To The Moment - Slash's Snakepit
Beautiful Day - U2 
Bem-Aventurados - Sagrado Coracao da Terra
Boa Noite Sao Paulo - Boogie Naipe
Born To Be Wild - Steppenwolf
Born to Run - Bruce Springsteen
Breakeven - The Script 
Brown Eyed Girl - Van Morrison
Caímos Juntos, Levantamos Juntos - Pense
California Girls - The Beach Boys
Castle on the Hill - Ed Sheeran
City Of Ocala - A Day To Remember
Clareou - Caraivana
Count on Me - Bruno Mars
Dance, Dance, Dance - Boogie Naipe
Dancing in the Dark - Bruce Springsteen 
Danger Zone - Kenny Loggins 
De Musica Ligera - Soda Stereo 
Don't Stop Believin' - Journey
Dont Stop Me Now - Queen 
Dust in the Wind - Kansas
Ébrio Hábito - Guilherme de Sá
En El Muelle De San Blas - Maná 
Esperança - Aliados
Explorador - Fother Muckers
Eye of the Tiger - Survivor 
Fill My World (feat. Myles Kennedy and The Conspirators) - Slash
Firework - Katy Perry
Free Fallin - Tom Petty 
Friday I'm In Love - Twenty One Two
Gangsta Boggie - Boogie Naipe
Go Your Own Way - Fleetwood Mac 
Good Life - OneRepublic 
Good Vibrations - The Beach Boys 
Hall of Fame - The Script
Happy - Pharrell Williams
Heart of Gold - Neil Young
Here Comes the Sun - The Beatles 
Heroes - David Bowie 
Ho Hey - The Lumineers
Hold the Line - Toto 
Home - Edward Sharpe & The Magnetic Zeros 
Hotel California - Eagles
Hunger Strike - EP Version - Halestorm
I Walk the Line - Johnny Cash
I Will Survive - Gloria Gaynor
I Will Wait - Mumford & Sons 
I'm Gonna Be (500 Miles) - The Proclaimers
If Today Was Your Last Day - Nickelback
João De Barro - Renato Vianna
Jump - Van Halen 
Just Feel Better (feat. Steven Tyler) - Santana
La Bachata - Manuel Turizo
La Gota Fria - Carlos Vives 
La Ingrata - Café Tacvba 
La Tortura - Shakira feat. Alejandro Sanz 
Labios Compartidos - Maná 
Life Is A Highway - Tom Cochrane
Like a Rolling Stone - Bob Dylan
Limon Y Sal - Julieta Venegas 
Livin la Vida Loca - Ricky Martin 
Livin on a Prayer - Bon Jovi 
Long Train Runnin' - The Doobie Brothers
Love on Top - Beyonce
Man on the Moon - R.E.M. 
Matador - Los Fabulosos Cadillacs 
Maybe It’s Time (feat. Corey Taylor, Joe Elliott, Brantley Gilbert, Ivan Moody, Slash, AWOLNATION, Tommy Vext) - Sixx:A.M.
Memories - Maroon 5
Mire as Estrelas - Rosa de Saron
Mojada - Vilma Palma
Não Viva Em Vão - Charlie Brown Jr.
On My Way - Phil Collins 
On Top of the World - Imagine Dragons 
One More Time - Daft Punk 
Oye Mi Canto - Gloria Estefan 
Péssimo Negócio - Maneva
Pisando Descalço - Maneva
Procedimientos Para Llegar a un Común Acuerdo - PXNDX
Purple Rain - Prince
Ramble On - Led Zeppelin 
Ramblin' Man - The Allman Brothers Band
Ready to Start - Arcade Fire 
RED, WHITE & YOU - Steven Tyler
Riptide - Vance Joy 
Road Trippin - Red Hot Chili Peppers 
Roar - Katy Perry 
Rock and Roll - Led Zeppelin
Rocket Man - Elton John
Rockstar - Nickelback
Route 66 - Chuck Berry
Setting Forth - Eddie Vedder
Shake It Out - Florence + The Machine 
Shut Up and Dance - Walk the Moon 
Sirens - Pearl Jam
Society - Eddie Vedder
Something Just Like This - The Chainsmokers & Coldplay 
Speed of Sound - Coldplay 
Start Me Up - The Rolling Stones
Stubborn Love - The Lumineers 
Sweet Home Alabama - Lynyrd Skynyrd
Take It Easy - Eagles
Take Me Home, Country Roads - John Denver
The Call - Acoustic Version - Ego Kill Talent
The Downfall Of Us All - A Day To Remember
The Edge of Glory - Lady Gaga 
The Hills - The Weeknd
The Longest Time - Billy Joel 
The River - Bruce Springsteen 
Time Will Come - Shaman
Times Like These - Foo Fighters 
Truckin' - The Grateful Dead
Um Minuto Para O Fim Do Mundo - CPM 22
Unstoppable - Sia 
Vida - Exxótica
Vinte e Seis - Guilherme de Sá
Vivir Sin Aire - Maná 
Voce e eu só - Boogie Naipe
Waiting on the World to Change - John Mayer 
We Are Young (feat Janelle Monae) - Fun. 
Whatever It Takes - Imagine Dragons 
Wish You Were Here - Pink Floyd 
You Cant Always Get What You Want - The Rolling Stones 
You Found Me - The Fray 